1 13 23
22212222122222122222222
2p  3333333333333     2
1   2222222222222     2
2    b    333         2
2     b   333         1
2      b  333  B      2
2       b 333         2
2        b333         2
2   b     333         2
2         333         2
2   2222222222222     2
2   3333333333333     2
12222222222212222222222